_____________
_B_B_M_M_B_B_
_B_B_MMM_B_B_
_B_B_M_M_B_B_
_B_B_____B_B_
_____________
M_MM_____MM_M
_____B_B_____
_B_B_MBM_B_B_
_B_B_B_B_B_B_
_B_B_____B_B_
_B_B_ZZZ_B_B_
____PZFZ_____